41 41 41 41 41 41 41 41 41 41 41 41 41 41 41 41 41 41 41 41 41 41 41 41 41 41 41 41 41 41 41 41 41 41 41 41 41 41 41 41 41 41 41 41 41 41 41 41 41 41
41 41 41 41 41 10 10 41 41 41 10 10 10 10 10 11 41 41 41 10 41 10 41 10 10 41 41 10 41 41 10 41 10 10 41 10 10 41 10 41 10 10 41 41 41 41 41 41 41 41
41 41 41 41 41 10 10 10 41 41 35 33 33 33 33 33 33 33 33 33 33 33 33 33 33 33 33 33 33 33 33 33 33 33 33 33 33 33 33 33 33 33 41 41 41 41 41 41 41 41
41 41 41 41 41 10 11 10 10 10 31 26 26 26 26 26 26 26 26 26 26 26 26 26 26 26 26 26 26 26 26 26 26 26 26 26 26 26 26 26 26 26 33 33 33 36 10 41 41 41
41 41 10 10 10 10 41 10 10 10 37 28 28 28 28 28 28 28 28 28 28 28 28 28 28 28 28 28 28 28 28 28 28 28 28 28 28 28 28 28 29 26 26 26 26 30 41 41 41 41
41 41 41 11 11 10 10 11 10 11 10 10 10 10 11 10 10 10 10 11 11 11 11 10 11 11 11 10 10 41 10 41 10 41 10 41 41 41 10 41 31 26 26 26 26 30 41 41 41 41
41 41 41 33 33 33 33 33 33 33 33 33 33 33 33 33 33 33 33 33 33 33 33 33 33 33 33 33 33 33 33 33 33 33 33 33 33 33 33 33 34 26 26 26 26 10 10 41 41 41
41 41 10 26 26 26 26 26 26 26 26 26 26 26 26 26 26 26 26 26 26 26 26 26 26 26 26 26 26 26 26 26 26 26 26 26 26 26 26 26 26 26 26 26 26 26 26 41 41 41
41 10 10 10 26 26 26 26 39 39 39 39 39 39 39 39 39 39 39 39 39 39 39 39 39 39 39 39 39 39 39 39 39 39 39 39 39 39 39 39 39 39 26 26 26 26 41 41 10 41
41 10 10 10 10 26 26 26 39 39 39 39 39 39 39 39 39 39 39 39 39 39 39 39 39 39 39 39 39 39 39 39 39 39 39 39 39 39 39 39 39 39 26 26 26 10 41 41 41 41
41 11 10 10 26 26 26 26 39 39 39 39 39 39 39 39 39 39 39 39 39 39 39 39 39 39 39 39 39 39 39 39 39 39 39 39 39 39 39 39 39 39 26 26 26 26 10 41 10 41
41 10 10 10 26 26 26 26 39 39 39 39 39 39 39 39 39 39 39 39 39 39 39 39 39 39 39 39 39 39 39 39 39 39 39 39 39 39 39 39 39 39 26 26 26 26 41 10 10 41
41 10 10 10 10 26 26 26 39 39 39 39 39 39 39 39 39 39 39 39 39 39 39 39 39 39 39 39 39 39 39 39 39 39 39 39 39 39 39 39 39 39 26 26 26 41 10 41 10 41
41 41 41 41 10 26 26 26 39 39 39 39 39 39 39 39 39 39 39 39 39 39 39 39 39 39 39 39 39 39 39 39 39 39 39 39 39 39 39 39 39 39 26 41 41 10 10 41 10 41
41 10 11 41 41 10 26 26 39 39 39 39 39 39 39 39 39 39 39 39 39 39 39 39 39 39 39 39 39 39 39 39 39 39 39 39 39 39 39 39 39 39 26 26 41 10 41 41 10 41
41 41 11 10 41 10 26 26 39 39 39 39 39 39 39 39 39 39 39 39 39 39 39 39 39 39 39 39 39 39 39 39 39 39 39 39 39 39 39 39 39 39 26 26 41 41 41 10 41 41
41 10 41 41 26 26 26 26 39 39 39 39 39 39 39 39 39 39 39 39 39 39 39 39 39 39 39 39 39 39 39 39 39 39 39 39 39 39 39 39 39 39 26 26 26 26 41 41 10 41
41 41 41 41 26 26 26 26 39 39 39 39 39 39 39 39 39 39 39 39 39 39 39 39 39 39 39 39 39 39 39 39 39 39 39 39 39 39 39 39 39 39 26 26 26 10 10 41 10 41
41 41 41 10 26 26 26 26 39 39 39 39 39 39 39 39 39 39 39 39 39 39 39 39 39 39 39 39 39 39 39 39 39 39 39 39 39 39 39 39 39 39 26 26 10 41 41 10 41 41
41 41 26 26 26 26 26 26 39 39 39 39 39 39 39 39 39 39 39 39 39 39 39 39 39 39 39 39 39 39 39 39 39 39 39 39 39 39 39 39 39 39 26 26 10 10 41 41 41 41
41 41 26 26 26 26 26 26 39 39 39 39 39 39 39 39 39 39 39 39 39 39 39 39 39 39 39 39 39 39 39 39 39 39 39 39 39 39 39 39 39 39 26 26 26 41 10 10 10 41
41 26 26 26 26 26 26 26 39 39 39 39 39 39 39 39 39 39 39 39 39 39 39 39 39 39 39 39 39 39 39 39 39 39 39 39 39 39 39 39 39 39 26 26 26 10 10 10 41 41
41 26 26 26 26 26 26 26 39 39 39 39 39 39 39 39 39 39 39 39 39 39 39 39 39 39 39 39 39 39 39 39 39 39 39 39 39 39 39 39 39 39 26 26 26 26 10 10 10 41
41 41 26 26 26 26 26 26 39 39 39 39 39 39 39 39 39 39 39 39 39 39 39 39 39 39 39 39 39 39 39 39 39 39 39 39 39 39 39 39 39 39 26 26 26 26 26 26 10 41
41 26 26 26 26 26 26 26 39 39 39 39 39 39 39 39 39 39 39 39 39 39 39 39 39 39 39 39 39 39 39 39 39 39 39 39 39 39 39 39 39 39 26 26 26 26 26 26 26 41
41 41 41 10 26 26 26 26 39 39 39 39 39 39 39 39 39 39 39 39 39 39 39 39 39 39 39 39 39 39 39 39 39 39 39 39 39 39 39 39 39 39 26 26 26 26 26 26 26 41
41 41 10 41 10 26 26 26 39 39 39 39 39 39 39 39 39 39 39 39 39 39 39 39 39 39 39 39 39 39 39 39 39 39 39 39 39 39 39 39 39 39 26 26 26 26 26 26 26 41
41 41 41 10 41 41 26 26 39 39 39 39 39 39 39 39 39 39 39 39 39 39 39 39 39 39 39 39 39 39 39 39 39 39 39 39 39 39 39 39 39 39 26 26 26 26 26 26 41 41
41 41 41 41 10 26 26 26 39 39 39 39 39 39 39 39 39 39 39 39 39 39 39 39 39 39 39 39 39 39 39 39 39 39 39 39 39 39 39 39 39 39 26 26 26 26 26 26 10 41
41 41 41 10 26 26 26 26 39 39 39 39 39 39 39 39 39 39 39 39 39 39 39 39 39 39 39 39 39 39 39 39 39 39 39 39 39 39 39 39 39 39 26 26 26 26 41 41 10 41
41 10 10 41 26 26 26 26 39 39 39 39 39 39 39 39 39 39 39 39 39 39 39 39 39 39 39 39 39 39 39 39 39 39 39 39 39 39 39 39 39 39 26 26 26 41 41 41 41 41
41 10 10 10 10 26 26 26 39 39 39 39 39 39 39 39 39 39 39 39 39 39 39 39 39 39 39 39 39 39 39 39 39 39 39 39 39 39 39 39 39 39 26 26 26 26 10 41 41 41
41 10 26 26 26 26 26 26 39 39 39 39 39 39 39 39 39 39 39 39 39 39 39 39 39 39 39 39 39 39 39 39 39 39 39 39 39 39 39 39 39 39 26 26 26 26 26 10 10 41
41 10 26 26 26 26 26 26 39 39 39 39 39 39 39 39 39 39 39 39 39 39 39 39 39 39 39 39 39 39 39 39 39 39 39 39 39 39 39 39 39 39 26 26 26 10 10 11 41 41
41 26 26 26 26 26 26 26 39 39 39 39 39 39 39 39 39 39 39 39 39 39 39 39 39 39 39 39 39 39 39 39 39 39 39 39 39 39 39 39 39 39 26 26 10 11 10 10 10 41
41 10 26 26 26 26 26 26 39 39 39 39 39 39 39 39 39 39 39 39 39 39 39 39 39 39 39 39 39 39 39 39 39 39 39 39 39 39 39 39 39 39 26 10 10 10 10 11 10 41
41 10 26 26 26 26 26 26 39 39 39 39 39 39 39 39 39 39 39 39 39 39 39 39 39 39 39 39 39 39 39 39 39 39 39 39 39 39 39 39 39 39 26 26 10 10 11 10 10 41
41 41 26 26 26 26 26 26 39 39 39 39 39 39 39 39 39 39 39 39 39 39 39 39 39 39 39 39 39 39 39 39 39 39 39 39 39 39 39 39 39 39 26 26 26 10 10 11 10 41
41 10 10 26 26 26 26 26 26 26 26 26 26 26 26 26 26 26 26 26 26 26 26 26 26 26 26 26 26 26 26 26 26 26 26 26 26 26 26 26 26 26 26 26 26 26 41 10 10 41
41 41 11 10 26 26 26 26 10 10 10 10 10 10 10 10 10 10 10 10 10 10 10 10 10 10 10 10 10 10 10 10 10 10 10 10 10 10 10 10 10 10 26 26 26 41 10 41 10 41
41 11 10 10 10 26 26 26 10 10 10 10 10 10 10 10 10 10 10 10 10 10 10 10 10 10 10 10 10 10 10 10 10 10 10 10 10 10 10 10 10 10 26 26 41 41 41 10 10 41
41 10 10 10 10 10 26 26 10 10 10 10 10 10 10 10 10 10 10 10 10 10 10 10 10 10 10 10 10 10 10 10 10 10 10 10 10 10 10 10 10 10 26 10 10 10 10 10 41 41
41 10 10 14 15 15 15 15 15 15 15 15 15 15 15 15 15 15 15 15 15 15 15 15 15 15 15 15 15 15 15 15 15 15 15 15 15 15 15 15 15 15 15 15 15 15 16 10 10 41
41 10 14 25 12 12 12 12 12 12 12 12 12 12 12 12 12 12 12 12 12 12 12 12 12 12 12 12 12 12 12 12 12 12 12 12 12 12 12 12 13 13 12 12 12 12 24 16 10 41
41 14 25 12 12 13 12 12 12 12 12 12 12 12 12 12 12 12 12 12 12 12 12 12 12 13 13 13 12 12 12 12 12 12 12 12 12 12 12 12 12 12 13 13 12 12 12 24 16 41
41 17 12 12 12 13 13 12 12 12 12 12 12 12 13 12 12 12 12 13 13 13 12 12 12 12 13 13 13 12 12 13 12 12 12 12 12 12 13 13 12 12 12 12 12 12 13 13 18 41
41 19 23 12 12 12 12 12 12 13 13 12 12 13 13 12 12 12 12 12 13 12 12 12 12 12 12 12 12 12 13 13 12 12 12 12 12 12 12 13 13 13 12 12 12 13 13 22 21 41
41 10 19 23 12 12 12 12 12 12 13 12 12 12 12 12 12 12 12 12 13 12 12 12 12 12 12 12 12 12 12 13 12 12 12 12 12 12 12 12 12 12 12 12 12 12 22 21 10 41
41 10 10 19 20 20 20 20 20 20 20 20 20 20 20 20 20 20 20 20 20 20 20 20 20 20 20 20 20 20 20 20 20 20 20 20 20 20 20 20 20 20 20 20 20 20 21 10 10 41
41 41 41 41 41 41 41 41 41 41 41 41 41 41 41 41 41 41 41 41 41 41 41 41 41 41 41 41 41 41 41 41 41 41 41 41 41 41 41 41 41 41 41 41 41 41 41 41 41 41
